XXXXXXX2222XXXXXXX
X D            H0X
X                X
X                X
X                X
X               UX
X    XXL  XH1    X
X     X XX       X
X    SXX         X
X     X XX H2    X
X    XX   X      X
X                X
X                X
X     B2         X
X                X
X              H0X
X           R    X
XXXXXXX1111XXXXXXX
